6
1 9 6 1
1 3 10 1
1 9 10 1
1 3 17 1
1 9 17 1
1 9 30 1
