3,3,3,3,3,3,3,3,7,6,7,6,3,3,3,3,3,3,3,3
3,3,6,7,6,7,6,7,6,7,6,7,6,7,6,7,6,7,3,3
3,3,7,6,7,6,7,6,7,6,7,6,7,6,7,6,7,6,3,3
3,3,6,7,6,7,6,7,6,7,6,7,6,7,6,7,6,7,3,3
3,3,7,6,7,6,7,6,7,6,7,6,7,6,7,6,7,6,3,3
3,3,6,7,6,7,6,7,6,7,6,7,6,7,6,7,6,7,3,3
3,3,7,6,7,6,7,6,7,6,7,6,7,6,7,6,7,6,3,3
3,3,6,7,6,7,6,7,6,7,6,7,6,7,6,7,6,7,3,3
3,3,7,6,7,6,7,6,7,6,7,6,7,6,7,6,7,6,3,3
